11111111111111111111111111
10000000000000000000000001
10000200000000000000000001
10000000000000000000000001
10000000200000000000000001
10000000000000000000000001
10000000000000000000000001
100000N0000010000000000001
10000000000000000000000001
10000000000000000000000001
10000000000000000000000001
10000000000000000000000001
10000000000000000000000001
10010001001000010001001001
11111111111111111111111111
