11111111
10000001
10002001
10000001
10001001
1000N001
10000001
11111111