11111111111111111111111111
10100000000000000000000001
10100000000000000000000001
10100000000000000000000001
1N100000000000000000000001
10000000000000000000000001
10000000000000000000000001
11110000000000000000000001
10000000000000000000000001
10000000000000000000000001
10000000000000000000000001
10000000000000000000000001
10000000000000000000000001
10010001001000010001001001
11111111111111111111111111
