11111111111111111111111111
10000000000000000000000001
10000000000000000000000001
10002200000000000000000001
10002200000000000000000001
10000000000010000000000001
10000000000000000000000001
10000000000010000000000001
10000000000000000000000001
10000000000000000000000001
10000000000000000000000001
1000000000000S000000000001
10000000000000000000000001
10010001001000010001001001
11111111111111111111111111
