R 1920 1080
NO ../textures/redbrick.xpm
SO ../textures/mossy.xpm
WE ../textures/bluestone.xpm
EA ../textures/redbrick.xpm
S ../textures/barrel.xpm
F 117, 148, 121
C 133, 175, 199

11111111111111111111111111
1S000000000000000000000001
10000000000000000000000001
10000000000000000000000001
10000000000000000000000001
10000000000000000000000001
10000000000000000000000001
11110000000000000000000001
10000000000000000000000001
10000000000000000000000001
10000000000000000000000001
10000000000000000000000001
10000000000000000000000001
10010001001000010001001001
11111111111111111111111111
