R 1920 1080
NO ../textures/wood.xpm
SO ../textures/mossy.xpm
WE ../textures/bluestone.xpm
EA ../textures/redbrick.xpm
S ../textures/barrel.xpm
F 117, 148, 121
C 133, 175, 199

11111111111111111111111111
10000000000000000000000001
10000200000000000000000001
10002222222220000000000001
10002222222200000000000001
10002222222210000000000001
10000N11111121000000000001
10000000000010000000000001
10000000000000000000000001
10000000000000000000000001
10000000000000000000000001
10000000000000000000000001
10000000000000000000000001
10010001001000010001001001
11111111111111111111111111
